./bin/programa;
abelisaurus - abelisaurus
achillobator - achillobator
afrovenator - afrovenator
aipichthys - aipichthys
albertosaurus - albertosaurus
alvarezsaurus - alvarezsaurus
anserimimus - anserimimus
archaeopteryx - archaeopteryx
archaeornithomimus - archaeornithomimus
avimimus - avimimus
bambiraptor - bambiraptor
baryonyx - baryonyx
becklespinax - becklespinax
buitreraptor - buitreraptor
carcharodon megalodon - carcharodon megalodon
carcharodontosaurus - carcharodontosaurus
caudipteryx - caudipteryx
chirostenotes - chirostenotes
coelacanth - coelacanth
coelophysis - coelophysis
confuciusornis - confuciusornis
xiphactinus audax - xiphactinus audax
cryolophosaurus - cryolophosaurus
deltadromeus - deltadromeus
dubreuillosaurus - dubreuillosaurus
dunkleosteus terrelli - dunkleosteus terrelli
elaphrosaurus - elaphrosaurus
enchodus - enchodus
eoraptor - eoraptor
fukuiraptor - fukuiraptor
gillicus arcuatus - gillicus arcuatus
holophagus - holophagus
hyneria lindae - hyneria lindae
indosuchus - indosuchus
masiakasaurus - masiakasaurus
nqwebasaurus - nqwebasaurus
pelicanimimus - pelicanimimus
podokesaurus - podokesaurus
shanag - shanag
urbacodon - urbacodon
Quantidade de ciclos: 40
